NO ./assets/texture/wall_north.xpm
SO ./assets/texture/wall_south.xpm
WE ./assets/texture/wall_west.xpm
EA ./assets/texture/wall_east.xpm

F 192,192,192
C 51,153,255

1111111111111111111111111
1000000000000000000000001
100000000000000000000E001
1000000000000000000000001
1111111111111111111111111