EA ./assets/texture/wall_east.xpm

F 220,100,0
C 225,30,0

11111111111111111111111111111
10000000001100000111011111111
11110000000000011100000010001
11110000000000011101010010001
11000000110101011100000010001
100000000000N0001100000010001
10000000000000001101010010001
11000001110101001000000000001
11110111 1110101 101111010001
11111111 1111111 111111111111
