NO ./assets/texture/wall_north.xpm
SO ./assets/texture/wall_south.xpm
WE ./assets/texture/wall_west.xpm
EA ./assets/texe/wall_east.xpm

F 96,96,96
C 32,32,32

11111111111111
110N0000000101
10000000010001
1000010000000001
11000000000111
100001111110101
11111111 1111111
