NO ./assets/texture/wall_north.xpm
SO ./assets/texture/wall_south.xpm
WE ./assets/texture/wall_west.xpm
EA ./assets/texture/wall_east.xpm

F 220,100,0
C 225,30,0

1111111111111111111111111
1000000000110000000000001
1011000001110000000000001
1001000000000E00000000001
1111111110110000011100001
1000000000110000011101111
1000000000000000110101001
1100000111010101111101111
1111111111111111111111111